# LABERINTO ANÁRQUICO
NOMBRE: DormirEsParaDebiles
FILAS: 15
COLUMNAS: 15
TIENE_SOLUCION: 1
PASOS_SOLUCION: 48
DATA:
2 1 0 0 0 0 0 0 0 0 0 0 0 0 0
1 1 0 1 1 1 1 1 1 1 1 1 1 1 0
0 1 0 1 0 0 0 0 0 1 0 0 0 1 0
0 1 0 1 0 1 0 1 1 1 0 1 1 1 0
0 1 0 1 0 1 0 1 0 0 0 1 0 0 0
0 1 0 1 1 1 0 1 0 1 1 1 0 1 0
0 1 0 0 0 0 0 1 0 1 0 0 0 1 0
0 1 1 1 1 1 1 1 0 1 1 1 1 1 0
0 0 0 0 0 0 0 0 0 0 0 0 0 1 0
0 1 1 1 1 1 1 1 1 1 1 1 0 1 0
0 1 0 1 0 0 0 0 0 0 0 1 0 1 0
0 1 0 1 1 1 1 1 1 1 0 1 0 1 0
0 1 0 0 0 0 0 0 0 1 0 0 0 1 0
0 1 1 1 1 1 1 1 0 1 1 1 1 1 1
0 0 0 0 0 0 0 0 0 0 0 0 0 1 3
